##############################
#                           e#
# ########################## #
# ########################## #
# ########################## #
# ########################## #
# ########################## #
# ########################## #
# ########################## #
# ########################## #
#                            #
##############################