##########################
##########################
#                        #
############ #############
############ #############
############ #############
############ #############
############ #############
##########################
