##############################
#                           e#
# ############ ############# #
# ############ ############# #
# ############ ############# #
# ############ ############# #
# ############ ############# #
# ############ ############# #
# ############ ############# #
# ############ ############# #
#                            #
###### ################# #####
###### ######## ######## #####
###### ######## ######## #####
###### ######## ######## #####
###### ######## ######## #####
###### ######## ######## #####
###### ######## ######## #####
###### ######## ######## #####
###### ######## ######## #####
######                   #####
###### ######## ######## #####
###### ######## ######## #####
###### ######## ######## #####
###### ######## ######## #####
###### ########          #####
###### ######## ##############
###### ######## ##############
#s              ##############
##############################

